NO .xpm
SO .xpm
WE .xpm
EA .xpm
F 2,1,1
C 1,1,125

11111
10001
10E01
10001
11111