NO .xpm
SO .xpm
WE .xpm
EA .xpm
F 2,1,1
C 1,1,125

111111
100011
10N001
100101
100011
111111