SO xpm/South.xpm                                                     
NO xpm/North.xpm                           
WE xpm/West.xpm                                                                                                         
EA xpm/East.xpm                         
C 1,255,255
F 222,1,254


111111111111111111111
10001000000011111111111111111
1001 1000000111111111111
10001000N00011111111111111
1111111111111
11111 11111 1
1111111111111