NO .xpm
SO .xpm
WE .xpm
EA .xpm
F 2,1,1
C 1,1,125

111111
100001
100001
1N0001
111111