SO xpm/Spatial1.xpm                                                     
NO xpm/Spatial2.xpm                           
WE xpm/Spatial3.xpm                                                                                                         
EA xpm/Spatial4.xpm                         
F 0,0,0
C 255,255,255

111111111111111
100000000000001
100000000000001
100000000000001
100000001000001
100000100000001
1000000N0000001
100000000000001
100000000000001
111111111111111