


SO xpm/Spatial2.xpm
NO xpm/Spatial2.xpm
WE xpm/Spatial2.xpm
EA xpm/Spatial2.xpm
F 122,0,255
C 255,255,255

111111111111111
100000000000001
100000000000001
100010000000001
1001 1000000001
100010000000001
1000000N0000001
100000000000001
100000000000001
111111111111111