NO .xpm
SO .xpm
WE .xpm
EA .xpm
F 2,1,1
C 1,1,125

111111
1000E1
100001
101111
111111