


SO xpm/Spatial1.xpm
NO xpm/Spatial2.xpm
WE xpm/Spatial3.xpm
EA xpm/Spatial4.xpm
F 122,0,255
C 255,255,255

1111111111111111111
100000000000001111E1
10000000000000111111
100000000000001111111111111111
100000000000001        1111111
100000000000001             1
100000000000001        111111
1000000000000011111111111111
100000000000001
111111111111111