NO .xpm
SO .xpm
WE .xpm
EA .xpm
F 2,1,1
C 1,1,125

11111111
10001011
10E01011
10001111
11111111