
SO xpm/Spatial1.xpm
NO xpm/Spatial2.xpm
WE xpm/Spatial3.xpm
F 1,1,1

EA xpm/Spatial4.xpm
  C 1,0,1




        11111111111111111111111111111111111111111111111111
        1000000000110000000000001
        1011000001110000000000001
        1001000000000000000000001
111111111011000001110000000000001
100000000011000001110111111111111
111101111111110111000000100011
111101111111110111010100100011111
110000001101000111000000100011
10000000000000W0100001100000101111
1000000000000001110101001000101101
1100000111010101111101111000101001
11110111 1110101 10111101000001001
111111111111111111111111111111111