
SO xpm/Spatial1.xpm
NO xpm/Spatial2.xpm
WE xpm/Spatial3.xpm
EA xpm/Spatial4.xpm
F 11,1,255
C 1,1,1

111111111111111111111111111111111111
111111111100000000011000000000000111
101100000111000000000000111111111111
100100000000000000000000111111111111
111111111011000001110000000000001111
10000000001100000111011111111111011111
11110111111111011100000010001111011101
11110111111111011101010010001111111111
111111111111111111111111111111111111
 
111111111111111111111111111111111111
110000001101000111000000100011111111
10000000000000W010000110000010111111
100000000000000111010100100010110111
110000011101010111110111100010100111
111101111111010111011110100000100111
111111111111111111111111111111111111